############################
   ....##..........##....   
######.##.########.##.######
#o...........##...........o#
#.#######.##.##.##.#######.#
#.##......##.##.##......##.#
#.##.####.##....##.####.##.#
#.##.####.########.####.##.#
######.##          ##.######
######.## ###DD### ##.######
#......## #      # ##......#
#...##.## ######## ##.##...#
###.##.##..........##.##.###
###.##.####.####.####.##.###
###.........#  #.........###
###.#######.####.#######.###
   ....##..........##....   
###.##.##.########.##.##.###
#...##.......##.......##...#
#.####.#####.##.#####.####.#
#..........................#
############################
